Jana Novák | Jano Novák
Jana Nováková | Jano Nováková
jana novak | Jano Novak
jana novakova | Jano Novaková
jana mrozko | Jano Mrozko
Ivana Veselá | Ivano Veselá
Kamil Tvarůžek | Kamile Tvarůžku
Ladislav Štěrba | Ladislave Štěrbo
Tomáš Řezník | Tomáši Řezníku
Jiří Novotný | Jiří Novotný
Jan Kříž | Jane Kříži
Jiří Dostál | Jiří Dostále
Milan Houra | Milane Houro
Eva Rudyjová | Evo Rudyjová
Kateřina Humlová | Kateřino Humlová
Ludmila Pokorna | Ludmilo Pokorná
Martina Šnajdrova | Martino Šnajdrov(a/á)
Radek Přílepek | Radku Přílepku
Václav Jůza | Václave Jůzo
Jiří Schweiner | Jiří Schweinere
ing.Pavel Stupárek | pane inženýre
Tomáš Jaroš | Tomáši Jaroši
Milos Hrdlicka | Milosi Hrdlicko
Eva Aulicka | Evo Aulická
Blanka Sítařová | Blanko Sítařová
Tomáš Strnad | Tomáši Strnade
Monika Průchová | Moniko Průchová
Petr Svoboda | Petře Svobodo
Petr Oleják | Petře Olejáku
Sysel Milan | Sysle Milane
Vratislav Mikan | Vratislave Mikane
Svatava Hladká | Svatavo Hladká
Jiří Čecháček | Jiří Čecháčku
Pavel Grégr | Pavle Grég(r/ř)e
Lukáš Hrubý | Lukáši Hrubý
Karlova Firma, s.r.o. | vážení
Lubomír Šimonka | Lubomíre Šimonko
Filip Kopřiva | Filipe Kopřivo
Spolek udržitelný rozvoj | vážení
Ondřej Krutil | Ondřeji Krutile
Jaroslav Kubálek | Jaroslave Kubálku
Josef Slanina | Josefe Slanino
Jiří Škorpil | Jiří Škorpile
Martina Skrebska | Martino Skrebská
Jaroslav Holík | Jaroslave Holíku
Miroslav Herbert Brause | Miroslave Herberte Brause
Inka Opavová | Inko Opavová
Robin Štec | Robine Šteci
Jarmila Maresova | Jarmilo Maresová
Jaroslav Čermák | Jaroslave Čermáku
Zbyněk Tkadlčík, fa Albatros | vážení
Lukáš Veselka | Lukáši Veselko
Petr Posad | Petře Posade
Petr Hnida | Petře Hnido
Jana Řeháková | Jano Řeháková
Milan Pospíšil | Milane Pospíšile
Martina Kolomazníková | Martino Kolomazníková
Katarína Bárková | Kataríno Bárková
LUDVÍK HULEŠ | Ludvíku Huleši
Bronislav Mik | Bronislave Miku
Petr Tomek | Petře Tomku
Marcel Samšiňák | Marceli Samšiňáku
Lucia Kornova | Lucio Kornová
Eliška Švecová | Eliško Švecová
Marek Bednář | Marku Bednáři
Erika Michnová | Eriko Michnová
Eva Rozmanová | Evo Rozmanová
Světlana Kozáková | Světlano Kozáková
Petr Jelinek | Petře Jelinku
Pavel Plečka | Pavle Plečko
Zlatko Máčel | Zlatko Máčele
Ladislav Kašpar | Ladislave Kašpare
Krejbich Zbyněk | Krejbichu Zbyňku
David Orság | Davide Orságu
Aleš Pavliňák | Aleši Pavliňáku
Václav Čepička | Václave Čepičko
Kateřina Háblová | Kateřino Háblová
Jana Vařáková | Jano Vařáková
Hana Kovářová | Hano Kovářová
Radek Sita | Radku Sito
Filip Révay | Filipe Révayi
Lenka Ježková | Lenko Ježková
Milan Sevelda | Milane Seveldo
Jiří Ostřížek (Lesy ČR) | Jiří Ostřížku
Jitka Svobodová | Jitko Svobodová
Michal Valenta | Michale Valento
František Hovád | Františku Hováde
Vladka sindelarova | Vladko Sindelarová
Jana Kamešová | Jano Kamešová
Miroslav Balcar | Miroslave Balcare
Tomáš Šubert | Tomáši Šuberte
Pavel Mašek | Pavle Mašku
Eva Gecová | Evo Gecová
Petr Šindelář | Petře Šindeláři
Jana Dušková | Jano Dušková
miroslav vobořil | Miroslave Vobořile
Pavel Trnečka | Pavle Trnečko
Martina Kubošniková | Martino Kubošniková
Jiří Petera | Jiří Petero
Jana Rolečková | Jano Rolečková
Vít Borůvka | Víte Borůvko
Jaroslava Kovandova | Jaroslavo Kovandová
Kateřina Červová | Kateřino Červová
Jana Vrťová | Jano Vrťová
Vladislav Hejl | Vladislave Hejle
Lukáš Bahounek | Lukáši Bahounku
Kateřina Valíková | Kateřino Valíková
Hnetila Jiri | Hnetilo Jiri
Tereza Volfová | Terezo Volfová
Zdeňka Pohořálková | Zdeňko Pohořálková
Ondřej Volmut | Ondřeji Volmute
Václav Pomezný | Václave Pomezný
Libuše Moravcová | Libuše Moravcová
Iveta Králová | Iveto Králová
Jan Beck | Jane Becku
Petr Stavěla | Petře Stavělo
Petr Lengál | Petře Lengále
Marta Fricková | Marto Fricková
Aleš Pozdník | Aleši Pozdníku
Jiří Orság | Jiří Orságu
Simona Adamčíková | Simono Adamčíková
Jiří Havlíček | Jiří Havlíčku
Vojtěch Brtník | Vojtěchu Brtníku
Monika Vrhelová | Moniko Vrhelová
Josef Mikulčík | Josefe Mikulčíku
Matěj Mour | Matěji Moure
Frantisek Plch | Frantisku Plchu
Jana Charvátová | Jano Charvátová
Lukáš Zwardoň | Lukáši Zwardoni
Petr Wolf | Petře Wolfe
Vladimír Joska | Vladimíre Josko
Miloš Vítek | Miloši Vítku
Jana Doležalová | Jano Doležalová
Arsenij Vereskov | Arseniji Vereskove
Zdenka Chocholatá MUDr. | paní doktorko
Libor Dronek | Libore Dronku
Richard Bábíček | Richarde Bábíčku
Ondřej Adam | Ondřeji Adame
Jan Jezbera | Jane Jezbero
Pavel Popel | Pavle Popele
Jaroslav Drbal | Jaroslave Drbale
Josef Sedláček | Josefe Sedláčku
Jan Kukučka | Jane Kukučko
Anna Formanek | Anno Formanek
Jiri Klement | Jiri Klemente
Nela Večeřová | Nelo Večeřová
Helena Ryšavá | Heleno Ryšavá
Jan Ivičič | Jane Ivičiči
Jana Svobodová | Jano Svobodová
Martina Linhartová | Martino Linhartová
Barbora Gargulakova | Barboro Gargulaková
Tomáš Domagala | Tomáši Domagalo
Markéta Nováková | Markéto Nováková
Lenka Sobotková | Lenko Sobotková
Luděk Král | Luďku Králi
Ladislav Patrman | Ladislave Patrmane
Vítězslav Chalúpek | Vítězslave Chalúpku
Lucie Novakova | Lucie Novaková
Hedvika Talpašová | Hedviko Talpašová
Tereza Kaňková | Terezo Kaňková
Helena Šebestiánová | Heleno Šebestiánová
Ivana Opravilová | Ivano Opravilová
Alena Bilačičová | Aleno Bilačičová
Tereza Hejková | Terezo Hejková
Daniel Mencl | Danieli Mencle
David Sehnálek | Davide Sehnálku
Tomáš Zeman | Tomáši Zemane
Lukáš Víta | Lukáši Víto
Simona Čuboková | Simono Čuboková
Tomas Mildorf | Tomasi Mildorfe
MILAN ROUDNÝ | Milane Roudný
Martin Pytr | Martine Pytře
Přemysl Plechač | Přemysle Plechači
Josef Novak | Josefe Novaku
Jitka Pivarčiová | Jitko Pivarčiová
Jakub Machala | Jakube Machalo
Petr Stifter | Petře Stiftere
Petr Tomíšek | Petře Tomíšku
Michal Vrabec | Michale Vrabče
Martina Kovaliková | Martino Kovaliková
David Novák | Davide Nováku
Jana Svobodova | Jano Svobodová
MICHAL KAŠPAR | Michale Kašpare
Ladislav Techl | Ladislave Techle
František Kunz | Františku Kunzi
Lukáš Markytán | Lukáši Markytáne
Petr Dvorský | Petře Dvorský
Ivo Jirkal | Ivo Jirkale
Karel Schuster | Karle Schustere
Jaroslav Németh | Jaroslave Némethe
Radek Navrátil | Radku Navrátile
Jitka Borůvka Danihelová | Jitko Borůvko Danihelová
Zuzana Svobodová | Zuzano Svobodová
František Darius | Františku Dari(e/usi)
Klára Mašková | Kláro Mašková
Martina Visolajská | Martino Visolajská
Filip Nieč | Filipe Nieči
Jan Muchka | Jane Muchko
Lubomír Polášek | Lubomíre Polášku
Jakub Opavský | Jakube Opavský
Tomáš Lisek Lisek | Tomáši Lisku
Blanka Leitermannová | Blanko Leitermannová
Jiri Friedel | Jiri Friedele
Přemysl Vrbka | Přemysle Vrbko
Pavel Lukáš | Pavle Lukáši
Radek Ryvola | Radku Ryvolo
Radim Gregr | Radime Gregre
Marek Velš | Marku Velši
Miroslav Zbránek | Miroslave Zbránku
David Zlatovský | Davide Zlatovský
Ondřej Zralý | Ondřeji Zralý
Lenka Habadová | Lenko Habadová
Helena Schierová | Heleno Schierová
Jaroslav Gaksch | Jaroslave Gakschi
Lucie Slováčková | Lucie Slováčková
Jan Cingel | Jane Cingle
Jiri Dobner | Jiri Dobnere
Marie Mrůzková | Marie Mrůzková
Lenka Furkalová | Lenko Furkalová
Pavel Musil | Pavle Musile
Lukáš Houdek | Lukáši Houdku
Marie Zelenková | Marie Zelenková
Vít Šorejs | Víte Šorejsi
Markéta Břinčilová | Markéto Břinčilová
Břetislav Jiránek | Břetislave Jiránku
Libor Fouma | Libore Foumo
Jana Daňkova | Jano Daňkov(a/á)
Zdeněk Landa | Zdeňku Lando
Jan Jan | Jane Jane
iva veselá | Ivo Veselá
Jan Látal | Jane Látale
Radka Nová | Radko Nová
Ondrej Šulek | Ondreji Šulku
Matej Tobola | Mateji Tobolo
Jana Štekbauerova | Jano Štekbauerov(a/á)
Štěpánka Křivánková | Štěpánko Křivánková
Alexander Brill | Alexandere Brille
Richard Vaškových | Richarde Vaškových
Zdeněk Brachař | Zdeňku Brachaři
Kamil Doležel | Kamile Doleželi
Jiří Benda | Jiří Bendo
Radka Šteflova | Radko Šteflov(a/á)
Lenka Kubicová | Lenko Kubicová
Josef Kotyk | Josefe Kotyku
Tomáš Hynek | Tomáši Hynku
Anna Barnetová | Anno Barnetová
Jan Holoubek | Jane Holoubku
Petr Hrubý | Petře Hrubý
Roman Marek | Romane Marku
Klára Dörflerová | Kláro Dörflerová
Petra Urbancová | Petro Urbancová
Jana Tuzickova | Jano Tuzicková
Petr Vondracek | Petře Vondracku
Alexandra Krupárová | Alexandro Krupárová
Daniel Hilger | Danieli Hilgere
Ondřej Sák | Ondřeji Sáku
Kristýna Plesníková | Kristýno Plesníková
Martin Pekarčík | Martine Pekarčíku
Jana Tomčalová | Jano Tomčalová
Ota Slaby | Oto Slaby
Jana Jirovská | Jano Jirovská
Petr Kolářský | Petře Kolářský
Tomáš Prudký | Tomáši Prudký
Jana Tučková | Jano Tučková
Jiří Přáda | Jiří Přádo
Hana Klicnarová | Hano Klicnarová
Petr Prùša | Petře Prùšo
Lenka Lankaš | Lenko Lankaš
Gabriel Puczok | Gabrieli Puczoku
Sedmíková, Lékárna Komín | vážení
Pavel Nachtmann | Pavle Nachtmanne
Michal Hlavatý | Michale Hlavatý
Jiří Hrotek | Jiří Hrotku
Roman Stejskal | Romane Stejskale
Hana Ševčíková | Hano Ševčíková
Luboš Walek | Luboši Walku
Martina Pospíšilová | Martino Pospíšilová
adam šrubař | Adame Šrubaři
Michaela Vopatová | Michaelo Vopatová
Jaroslav Rak, MUDr. | pane doktore
Jitka Šenkýřová | Jitko Šenkýřová
Tomas Kučera | Tomasi Kučero
Zdeněk Suchý | Zdeňku Suchý
Kateřina Bílecká | Kateřino Bílecká
Petr Lejsal | Petře Lejsale
Zuzana Pustowková | Zuzano Pustowková
David Ježek | Davide Ježku
Vendula Švejdová | Vendulo Švejdová
Libuše Brožová | Libuše Brožová
Jana Růžičková | Jano Růžičková
Jaroslav Kohani | Jaroslave Kohani
Tereza Macounová | Terezo Macounová
Petráš Vlastimil | Petráši Vlastimile
Věra Nagyová | Věro Nagyová
Michaela Sedničková | Michaelo Sedničková
Zdeněk Heřman | Zdeňku Heřmane
klein Arnošt | Kleine Arnošte
Tadeáš Jurča | Tadeáši Jurčo
Jitka Babincová | Jitko Babincová
Ondřej Musil | Ondřeji Musile
Viera Křížová | Viero Křížová
Alena Janková | Aleno Janková
Arnošt Miroslav | Arnošte Miroslave
Eva Budinská | Evo Budinská
Hana Malíková | Hano Malíková
František Truhlář | Františku Truhláři
Šanda Luděk | Šando Luďku
Vlasta Junková | Vlasto Junková
Eva Coufalová | Evo Coufalová
Jiří Peruth | Jiří Peruthe
Fedor Kuzár | Fedore Kuzáre
Michaela Vaisarova | Michaelo Vaisarová
Alex Kraftová | Alex Kraftová
Petr Vacek | Petře Vacku
Josef Dostál | Josefe Dostále
Lenka Čaplová | Lenko Čaplová
Eva Schořová | Evo Schořová
Radek Roušal | Radku Roušale
Přemysl Štěpán | Přemysle Štěpáne
Jana Musílková | Jano Musílková
Michaela Schovankova | Michaelo Schovanková
Tereza Pištorová | Terezo Pištorová
vojtech pivnicka | Vojtechu Pivnicko
Jaroslav L. Fisnar | Jaroslave L. Fisnare
Marek Današ | Marku Današi
Jan Kovařovič | Jane Kovařoviči
Pavel Škvor | Pavle Škvore
Anna Machů | Anno Machů
Radek Císař | Radku Císaři
Michaela Petříková | Michaelo Petříková
Gabriela Švarcová | Gabrielo Švarcová
Jaroslav Slowik | Jaroslave Slowiku
Libuše Jandova | Libuše Jandová
Lemberger Jiří | Lembergere Jiří
Petr KNORR | Petře Knorre
Milada Majerová | Milado Majerová
Jiří Strnad | Jiří Strnade
Renáta Guxová | Renáto Guxová
Václav Záveský | Václave Záveský
Michal Vašek | Michale Vašku
Tomáš Stredl | Tomáši Stredle
Zdena Krylová | Zdeno Krylová
Libor Tišnovský | Libore Tišnovský
Lenka Mojžíšová | Lenko Mojžíšová
Jana Jílková | Jano Jílková
Vendula Pribylova | Vendulo Pribylová
Petr Malčok | Petře Malčoku
Michal Divílek | Michale Divílku
Luděk Hanzl | Luďku Hanzle
Dana Jančarová | Dano Jančarová
ZŠ Antonína Čermáka | vážení
Jozef Demský | Jozefe Demský
Jiří Rektořík | Jiří Rektoříku
Vít. Ledvinka | Víte Ledvinko
Marie Tesařová | Marie Tesařová
Radomír Škoda | Radomíre Škodo
Jarmila Sochorová | Jarmilo Sochorová
Monika Blažková | Moniko Blažková
Václav Reif | Václave Reife
Roman Habrle | Romane Habrle
Roman Novotný | Romane Novotný
Petr Pospisil | Petře Pospisile
Renata Hanáčková | Renato Hanáčková
Hana Stupková | Hano Stupková
Michaela Otýsová | Michaelo Otýsová
Michal Reitoral | Michale Reitorale
Igor Galia | Igore Galio
Katarina Kovalova | Katarino Kovalova
Josef Malina | Josefe Malino
Miloslav Ďurina | Miloslave Ďurino
Jarmila hribova | Jarmilo Hribová
Zdeněk Bartík | Zdeňku Bartíku
Martina Geyerová | Martino Geyerová
Hana Rusinková | Hano Rusinková
Kosatík Petr | Kosatíku Petře
Jan Vlašic | Jane Vlašici
Tomáš Černý | Tomáši Černý
Tereza Fialova | Terezo Fialová
Jana Dočkalová | Jano Dočkalová
Jakub Pollak | Jakube Pollaku
Lenka Kotačková | Lenko Kotačková
Němec Petr | Němče Petře
Jaroslava Blažková | Jaroslavo Blažková
Hana Zengerová | Hano Zengerová
Jan Jančík | Jane Jančíku
Vladan Vinklárek | Vladane Vinklárku
Josef Zápotočný | Josefe Zápotočný
Jana Endalová | Jano Endalová
Hana Nábělková | Hano Nábělková
Alena Telatynska | Aleno Telatynská
Petra Kubitová | Petro Kubitová
Kateřina Pavlicova | Kateřino Pavlicová
Oldřiška Servusová | Oldřiško Servusová
Bedřich Brumovský | Bedřichu Brumovský
Alena Šťastníková | Aleno Šťastníková
Josef rohac | Josefe Rohaci
Jiří Jedlička | Jiří Jedličko
Lukáš Světlý | Lukáši Světlý
Pavel Šourek | Pavle Šourku
Petra Dicová | Petro Dicová
Václav Havran | Václave Havrane
Klara Kondelikova | Klaro Kondeliková
Pavel Janoušek | Pavle Janoušku
Martin Jazembovsky | Martine Jazembovsky
Emilie Dudová | Emilie Dudová
vladislav louda | Vladislave Loudo
Jiri Holub | Jiri Holube
Petr Štejr | Petře Štejre
Andrej Tatka | Andreji Tatko
Steven Hájek | Stevene Hájku
Pavel Marek | Pavle Marku
Kateřina Baumgartl | Kateřino Baumgartl
Júlia Šamajová | Júlie Šamajová
Ilona Nehybová | Ilono Nehybová
Petr Cinek | Petře Cinku
Jiří Kubic | Jiří Kubici
Marcela Bouberlová | Marcelo Bouberlová
Broňa Havlikova | Broňo Havliková
Kateřina Rubáčková | Kateřino Rubáčková
Jan Hrbek | Jane Hrbku
Jaroslava Čálková | Jaroslavo Čálková
Pavlína Kozáková | Pavlíno Kozáková
Eva Čížková | Evo Čížková
Bronislav Mandinec | Bronislave Mandinče
Petr Bříza | Petře Břízo
Patrik Sluka | Patriku Sluko
Alena Foldová | Aleno Foldová
Lukáš Zívr | Lukáši Zívre
Jiřina Švarcová | Jiřino Švarcová
Pavel Nachtigal | Pavle Nachtigale
Roman Sečkař | Romane Sečkaři
Andrea Hájková | Andreo Hájková
Marek Kränkel | Marku Kränkele
Jan Rýdel | Jane Rýdele
Hana Starkova | Hano Starková
Antonín Janoš | Antoníne Janoši
Jana Čížková | Jano Čížková
Vera Chovancova | Vero Chovancová
David Pulkrábek | Davide Pulkrábku
Václav Hruška | Václave Hruško
Zdenek Bahounek | Zdenku Bahounku
Vítězslav Kopecký | Vítězslave Kopecký
Jarmila Mikesková | Jarmilo Mikesková
Jana Kožúriková | Jano Kožúriková
Hana Šimůnková | Hano Šimůnková
Andrea Meluzinova | Andreo Meluzinová
Pavel Pěcha | Pavle Pěcho
Denisa Nitschová | Deniso Nitschová
Lucie Lehnertová | Lucie Lehnertová
Jaroslav Tureček | Jaroslave Turečku
Roman Kunz | Romane Kunzi
Martin Slavík | Martine Slavíku
Vít Peterka | Víte Peterko
Ladislav Henzl ml | Ladislave Henzle
Martin Klima | Martine Klimo
Markéta Košíková | Markéto Košíková
Ing. Eduard Dolejší | pane inženýre
Jaroslav Habrnál | Jaroslave Habrnále
Michaela Šrámková | Michaelo Šrámková
Michaela Dráždilová | Michaelo Dráždilová
Zdeněk Čamek | Zdeňku Čamku
Tom Lukeš | Tome Lukeši
Petr Ilgner | Petře Ilgnere
JAN LAUBE | Jane Laube
Elena Hnatičová | Eleno Hnatičová
Anděla Sehedi | Andělo Sehedi
Miloslava Mrázková | Miloslavo Mrázková
Fiurášek martin | Fiurášku Martine
Sandra Kašparová | Sandro Kašparová
Petr Fessl | Petře Fessle
Michal Roh | Michale Rohu
Pospíšilová Bavlnářská | vážení
Emanuel Hanek | Emanueli Hanku
Marie Šperková | Marie Šperková
Karel Paseka | Karle Paseko
Miloslav Vilímek | Miloslave Vilímku
Michaela Hůrková | Michaelo Hůrková
Lenka Foltýnová | Lenko Foltýnová
Dagmar Šašinková | Dagmar Šašinková
Vojtěch Váňa | Vojtěchu Váňo
Petr Klimek | Petře Klimku
Lucie Raclavská | Lucie Raclavská
Vlastislav Derka | Vlastislave Derko
Novák Tomáš | Nováku Tomáši
Vladimíra Králová | Vladimíro Králová
Petr Belanyi | Petře Belanyi
Ales cerny | Alesi Cerny
Milan Jaroš | Milane Jaroši
Jana Štědronská | Jano Štědronská
Viktor Reischig | Viktore Reischigu
Lucie Šumberová | Lucie Šumberová
Simona Briestenská | Simono Briestenská
Šárka Sobotková | Šárko Sobotková
Štěpánka Tomanová | Štěpánko Tomanová
Lucie Ševčíková | Lucie Ševčíková
Petra Vampolová | Petro Vampolová
Jitka Zadražilová | Jitko Zadražilová
Jaroslava Šintalová | Jaroslavo Šintalová
Kristýna Šálková | Kristýno Šálková
Martin Brechličuk | Martine Brechličuku
Jana Rosíková | Jano Rosíková
Petr Zahálka | Petře Zahálko
Eva Bryndová | Evo Bryndová
Ludmila Janíková | Ludmilo Janíková
Zdeněk Petrželka | Zdeňku Petrželko
Petr Hyer | Petře Hyere
Lubomír Šilar | Lubomíre Šilare
Pavel Kopecký | Pavle Kopecký
Roman Pinkava | Romane Pinkavo
Alena Němcová | Aleno Němcová
Jana Buňatová | Jano Buňatová
Hana Vondráčková | Hano Vondráčková
Okrasná zahrada Osoblaha, s.r.o. | vážení
Andrea Werlíková | Andreo Werlíková
Vladimira Jiroušková | Vladimiro Jiroušková
Silvie Vykydalová | Silvie Vykydalová
Hana Soukupova | Hano Soukupová
Jaroslav Dvořák | Jaroslave Dvořáku
Veronika Krocová | Veroniko Krocová
Lubomír Kasal | Lubomíre Kasale
Alena Šimerdová | Aleno Šimerdová
Alena Randáková | Aleno Randáková
Iva Komínková | Ivo Komínková
Petr Daněk | Petře Daňku
Radim Dlouhý | Radime Dlouhý
Josef Grus | Josefe Grusi
Klára Stuchlíková | Kláro Stuchlíková
petr hora | Petře Horo
Jakub Kotva | Jakube Kotvo
František Sejrek | Františku Sejrku
Pavel Vávra | Pavle Vávro
Karolína Blechová | Karolíno Blechová
Vlastimil Adamovský | Vlastimile Adamovský
Liška Michal | Liško Michale
Irena Staňková | Ireno Staňková
Vojtěch Šticka | Vojtěchu Šticko
Lucie Chudobova | Lucie Chudobová
Neckarova Jana | Neckarová Jano
Václav Kolář | Václave Koláři
Jarmila Worková | Jarmilo Worková
Lucie Hochmannová | Lucie Hochmannová
Radka Michalová | Radko Michalová
Eva Vyhnálková | Evo Vyhnálková
Petr Kašpárek | Petře Kašpárku
Josef Růžička | Josefe Růžičko
Ivan Loužil | Ivane Loužile
František Landa | Františku Lando
Matouš Hodula | Matouši Hodulo
Michal Dzurina | Michale Dzurino
Miloš Komenda | Miloši Komendo
Ladislav Jirka | Ladislave Jirko
Peter Cibulka | Petere Cibulko
Marek Malík | Marku Malíku
Jan Růžička | Jane Růžičko
Luboš Vrzal | Luboši Vrzale
Lenka Březikova | Lenko Březikova
Vlastimil Kufa | Vlastimile Kufo
Zuzana Rajtorová | Zuzano Rajtorová
Václav Novotný | Václave Novotný
Miroslav Kalousek | Miroslave Kalousku
Ondřej Uhrecký | Ondřeji Uhrecký
Dušan Rychnovsky | Dušane Rychnovsky
Michal Vojtěch | Michale Vojtěchu
Ivana Hotová | Ivano Hotová
Dusan Dolezal | Dusane Dolezale
Pavel Zubík | Pavle Zubíku
Petra Mrázková | Petro Mrázková
Tomáš Gvoždík | Tomáši Gvoždíku
Libor Goj | Libore Goji
Milan Polášek | Milane Polášku
Jakub Čečetka | Jakube Čečetko
Pechová Tereza | Pechová Terezo
Luděk Domecký | Luďku Domecký
Alžběta Klímová | Alžběto Klímová
Marie Tomanová | Marie Tomanová
Jan Šimek | Jane Šimku
Petr Beneš | Petře Beneši
Jaroslav Hošek | Jaroslave Hošku
Veronika Vrsanska | Veroniko Vrsanská
Zbyněk Pospíšil | Zbyňku Pospíšile
Dana Vondrusová | Dano Vondrusová
Petr Slepánek | Petře Slepánku
Radek Knap | Radku Knape
Bedřich Reischl | Bedřichu Reischle
Martin Hamouz | Martine Hamouzi
Marie Kargerová | Marie Kargerová
Pavel Kášek | Pavle Kášku
Markéta Frčková | Markéto Frčková
Antonín Klauda | Antoníne Klaudo
Bára Horcickova | Báro Horcicková
Jana Brabcová | Jano Brabcová
Denisa Lipowczan | Deniso Lipowczan
Jana Jelínková | Jano Jelínková
Ivo Vlček | Ivo Vlčku
Petra Hudcová | Petro Hudcová
Jitka Braunerová | Jitko Braunerová
Petr Opálka | Petře Opálko
Pavel Novak | Pavle Novaku
Jan Klucký | Jane Klucký
Martin Klasovitý | Martine Klasovitý
Roman Kratochvíl | Romane Kratochvíle
Miloš Boháč | Miloši Boháči
Jan Ilenčík | Jane Ilenčíku
Jana Najmanová | Jano Najmanová
Petr Zákora | Petře Zákoro
Petr Žemlička | Petře Žemličko
Pavla Hutterová | Pavlo Hutterová
Monika Pechová | Moniko Pechová
Jaroslava Axmannová | Jaroslavo Axmannová
Mihailo Jovanović | Mihailo Jovanovići
Nagy Ladislav | Nagyi Ladislave
Denisa Strnádková | Deniso Strnádková
Zdeněk Bouzek | Zdeňku Bouzku
Ivana Danelová | Ivano Danelová
Jiří Slabý | Jiří Slabý
vendula koubkova | Vendulo Koubková
jana andersova | Jano Andersová
Alexandra Bodláková | Alexandro Bodláková
Jakub Mlčoch | Jakube Mlčochu
Radka Kociánová | Radko Kociánová
Kurt Mischek | Kurte Mischku
Pavla Masaříková | Pavlo Masaříková
Jana Urbanová | Jano Urbanová
Petr Stružka | Petře Stružko
Roman Ratajský | Romane Ratajský
Jaroslav Studený | Jaroslave Studený
Petr Žila | Petře Žilo
Kamil Kovarik | Kamile Kovariku
Pavla Bálská | Pavlo Bálská
Alena Gottfried | Aleno Gottfried
ALENA JURASKOVA | Aleno Jurasková
Toupalova bozena | Toupalová Bozeno
Daniel Sobotka | Danieli Sobotko
Oldřich Chvátal | Oldřichu Chvátale
Julie Dvorská | Julie Dvorská
MONT-ALU, s.r.o. | vážení
Daniel Kristek | Danieli Kristku
Evženie Spiříková | Evženie Spiříková
Josef Weigl | Josefe Weigle
Lucia Bahíková | Lucio Bahíková
Adam Russ | Adame Russi
Lenka Dufková | Lenko Dufková
Richard Bittner | Richarde Bittnere
Věra Struharova | Věro Struharová
Jana Chaloupková | Jano Chaloupková
Richard Čepička | Richarde Čepičko
Jan Pokálený | Jane Pokálený
Petra Šimek Jágrová | Petro Šimek Jágrová
Jiří Janoušek | Jiří Janoušku
Josef Korál | Josefe Koráli
Jiří Čunát | Jiří Čunáte
Petr Hrdlička | Petře Hrdličko
Martina Halaszova | Martino Halaszová
Marcela Klímová | Marcelo Klímová
Milan Mudruňka | Milane Mudruňko
Zbyněk Češka | Zbyňku Češko
Jana Marešová | Jano Marešová
Slavka Sisakova | Slavko Sisaková
Miroslav Kutal | Miroslave Kutale
Petr Tišer | Petře Tišere
Dita Radvanovská | Dito Radvanovská
Iveta Ulčáková | Iveto Ulčáková
Jan Skalák | Jane Skaláku
Pavel Siegl | Pavle Siegle
Jakub Lenek | Jakube Lenku
Lenka Kulhava | Lenko Kulhavá
Petr Srovnal | Petře Srovnale
Libor Tvarůžek | Libore Tvarůžku
Klára Dokoupil Banotová | Kláro Dokoupil Banotová
Dušan Žabčík | Dušane Žabčíku
Veronika Lorencová | Veroniko Lorencová
Terezie Pokorná | Terezie Pokorná
Ilona Fialová | Ilono Fialová
Milan Klimakovský | Milane Klimakovský
Miloš Drapač | Miloši Drapači
Dagmar Matějková | Dagmar Matějková
Pavel Nikl | Pavle Nikle
Antonin Zavrel | Antonine Zavreli
Petr Petko | Petře Petko
Roman Dvořáček | Romane Dvořáčku
Helena Korčáková | Heleno Korčáková
Jozef Niemiec | Jozefe Niemieci
Milena Klinská | Mileno Klinská
Roman Doležal | Romane Doležale
Roman Jurek | Romane Jurku
Vladimír Lampíř | Vladimíre Lampíři
Zuzana Časná | Zuzano Časná
Petr Mikulenka | Petře Mikulenko
Václav Lohr | Václave Lohre
Miroslava Marešová | Miroslavo Marešová
Jan Zástěra | Jane Zástěro
Pavel Kolafa | Pavle Kolafo
Miloslav Diviš | Miloslave Diviši
Jiří Čížek | Jiří Čížku
Jaromír Pospíšil | Jaromíre Pospíšile
Pavel Kouřil | Pavle Kouřile
Martin Hrkal | Martine Hrkale
Jiří Maček | Jiří Mačku
Martin Kőrmendy - UNIVERA | vážení
Barbora Kožušníková | Barboro Kožušníková
Jakub Halaška | Jakube Halaško
Karel Urbančík | Karle Urbančíku
Ladislav Zelený | Ladislave Zelený
Ivana Heranová | Ivano Heranová
Ladislav Kocman | Ladislave Kocmane
Jan Majkút | Jane Majkúte
Milan Mládek | Milane Mládku
Oľga Šalingová | Oľgo Šalingová
Věra Tichakova | Věro Tichaková
Petr Haubelt | Petře Haubelte
Ludmila Šebová | Ludmilo Šebová
Lukáš Procházka | Lukáši Procházko
Oldřich Vodrážka | Oldřichu Vodrážko
Věra Orlíková | Věro Orlíková
Ivana Remerová | Ivano Remerová
Šárka Hajzlerová | Šárko Hajzlerová
Miloslav Kern | Miloslave Kerne
Petra Job | Petro Job
Lenka Kohoutková | Lenko Kohoutková
Alena Urbančíková | Aleno Urbančíková
Milan Vrbský | Milane Vrbský
Roman Pírek | Romane Pírku
Ondřej Hýža | Ondřeji Hýžo
Ing. Helena Hrůzová | paní inženýrko
Regina Křetínská | Regino Křetínská
Michal Pastorek | Michale Pastorku
Michal Holek | Michale Holku
Martin Richta | Martine Richto
Jan Němec | Jane Němče
František Uhlíř | Františku Uhlíři
Erika Janáčová | Eriko Janáčová
Pavlína Přenosilová | Pavlíno Přenosilová
Josef Kuchař | Josefe Kuchaři
Petra Musilová | Petro Musilová
Marcela Pařízková | Marcelo Pařízková
Radek Janča | Radku Jančo
Karel Frejlich | Karle Frejlichu
Adam Glowiak | Adame Glowiaku
FARMA LISEC | vážení
Eva Šmerdová | Evo Šmerdová
Robert Wganer | Roberte Wganere
Tomas Pippal | Tomasi Pippale
Lucie Kopecká | Lucie Kopecká
Patrik Wehovský | Patriku Wehovský
František Harčár | Františku Harčáre
Jana Kohoutková | Jano Kohoutková
Helena Sedláková | Heleno Sedláková
Jiří Abrahám | Jiří Abraháme
Ievgeniia Skrypnykova | Ievgenije Skrypnykova
Petra Kyptová | Petro Kyptová
Monika Juklíková | Moniko Juklíková
jiří Leubner | Jiří Leubnere
Petr Smolka | Petře Smolko
Miroslav Čajka | Miroslave Čajko
Vlastimil Brtek | Vlastimile Brtku
Petr Ševčík | Petře Ševčíku
Bohdan Pustowka | Bohdane Pustowko
Miluše Eliášová | Miluše Eliášová
Miroslav Stefek | Miroslave Stefku
Jan Šťastný | Jane Šťastný
Marcela Burešová | Marcelo Burešová
Vladimír Kneř | Vladimíre Kneři
Olga Kopecka | Olgo Kopecká
Ondřej Valena | Ondřeji Valeno
Tomáš Nykodem | Tomáši Nykodeme
karel baroch | Karle Barochu
Pavel Stanke | Pavle Stanke
Nadim Mohamed | Nadime Mohamede
Stanislav Žvák | Stanislave Žváku
Pavel Zima | Pavle Zimo
Anita Nižnanská | Anito Nižnanská
Rostislav Beseda | Rostislave Besedo
Jarmila Adamová | Jarmilo Adamová
Tereza Rybáková | Terezo Rybáková
Jiřina Havlová | Jiřino Havlová
Ivo Gec | Ivo Geci
Hana Janů | Hano Janů
Petr Král | Petře Králi
Martin Tichý | Martine Tichý
Marta Linartová | Marto Linartová
Václav Lipovčan | Václave Lipovčane
Jitka Skálová | Jitko Skálová
Růžena Hazuchova | Růženo Hazuchová
Kamil Ošmera | Kamile Ošmero
Karin Haltmarová | Karin Haltmarová
Stanislav Tomčiak | Stanislave Tomčiaku
Libuše Kolíbalová | Libuše Kolíbalová
jaroslav just | Jaroslave Juste
Božena Čiháková | Boženo Čiháková
Milan Držmíšek | Milane Držmíšku
Jiří Nosek | Jiří Nosku
Luboš Frič | Luboši Friči
Martin Hrdý | Martine Hrdý
Martin Kaisrlík | Martine Kaisrlíku
Lenka Žváčková | Lenko Žváčková
Miloš Votava | Miloši Votavo
Kučera Pavel | Kučero Pavle
Vladimír Poledno | Vladimíre Poledno
Pavel Holoubek | Pavle Holoubku
Veronika Pačisková | Veroniko Pačisková
Michal Šiška | Michale Šiško
Ondřej Slezák | Ondřeji Slezáku
Jan Proskovec | Jane Proskovče
Soňa Formánková | Soňo Formánková
Zdeňka Ďurinová | Zdeňko Ďurinová
Hynek Tkadleček | Hynku Tkadlečku
František Kříž | Františku Kříži
Ivana Pechová | Ivano Pechová
Luděk Skala | Luďku Skalo
Klaudia Černá | Klaudio Černá
Marta Janoušková | Marto Janoušková
Alžběta Ryšánková | Alžběto Ryšánková
Marie Zbranková | Marie Zbranková
Jakub Měkyna | Jakube Měkyno
Lenka Hertlová | Lenko Hertlová
Anna Hubingerová | Anno Hubingerová
Petra Stará | Petro Stará
Jiri Grill | Jiri Grille
Hana Frkalova | Hano Frkalová
Michal Havlíček | Michale Havlíčku
Jaroslava Vondrašová | Jaroslavo Vondrašová
František Lenďák | Františku Lenďáku
Tomáš Binar | Tomáši Binare
Pavel Wagner | Pavle Wagnere
Radovan Krhovják | Radovane Krhovjáku
Václav Kasl | Václave Kasle
Alena Kolářová | Aleno Kolářová
Ondřej Sysel | Ondřeji Sysle
Alena Šonkova | Aleno Šonková
Vladimír Borčin | Vladimíre Borčine
Ivana Konířová | Ivano Konířová
VERONIKA DVORANOVÁ | Veroniko Dvoranová
Pavlína Steinerová | Pavlíno Steinerová
Petr Hanzlík | Petře Hanzlíku
Daniela Mácová | Danielo Mácová
Martin Ben | Martine Bene
Radek Wilham | Radku Wilhame
Eva Kalandrova | Evo Kalandrová
Areál Jip | vážení
Zuzana Koptová | Zuzano Koptová
Vladimír Krčma | Vladimíre Krčmo
Pavlína Rýglová | Pavlíno Rýglová
Patrik Gross | Patriku Grossi
Hana Mašková | Hano Mašková
Jiří Vojta | Jiří Vojto
tomas prokop | Tomasi Prokope
Ladislava Rozsívalová | Ladislavo Rozsívalová
Hedvika Vávrová | Hedviko Vávrová
Patrik Günter | Patriku Güntere
Petr Jilek | Petře Jilku
Daniel Lakatoš | Danieli Lakatoši
Tomáš Najzar | Tomáši Najzare
Hanuš Jiřinský | Hanuši Jiřinský
Ivan Přibyl | Ivane Přibyle
Tůma Martin | Tůmo Martine
Marie Slabá | Marie Slabá
Michaela Štěpánková | Michaelo Štěpánková
Erika Rendlová | Eriko Rendlová
Vít Petrželka | Víte Petrželko
Pavla Omamiková | Pavlo Omamiková
Anastasia Novotná | Anastasie Novotná
Pavla Vymazalová | Pavlo Vymazalová
Petra Povolná | Petro Povolná
Josef Janků | Josefe Janků
Michal Király | Michale Királyi
Jan Málek | Jane Málku
Jan Kubačák | Jane Kubačáku
Jan Fogl | Jane Fogle
Karel Zíka | Karle Zíko
Radek Šebestík | Radku Šebestíku
Ilona Karaskova | Ilono Karasková
Radka Nevludová | Radko Nevludová
Marie Nymsová | Marie Nymsová
Monika Waliszewská | Moniko Waliszewská
Markéta Mikoškovà | Markéto Mikošková
Marie Macháňová | Marie Macháňová
Dana Vondrušková | Dano Vondrušková
Bien Zenker | Biene Zenkere
Lenka Ježová Bichlerová | Lenko Ježová Bichlerová
Petr Šebela | Petře Šebelo
Martina Havlíčková | Martino Havlíčková
Petr Niklfeld | Petře Niklfelde
Janka Lašová | Janko Lašová
Vítězslav Staroštík | Vítězslave Staroštíku
Patrik Slovák | Patriku Slováku
Katka Foudová | Katko Foudová
Martin Pláteník | Martine Pláteníku
Salon Slunečnice | vážení
Eva Kučova | Evo Kučova
Peter Cicman | Petere Cicmane
Michaela Kovářová | Michaelo Kovářová
Pavel Chvátal | Pavle Chvátale
Jana Netušilová | Jano Netušilová
Marta Kvapilová | Marto Kvapilová
Petr Klepáček | Petře Klepáčku
Martin Kraut | Martine Kraute
Milan Rozmarin | Milane Rozmarine
Alena Gramatová | Aleno Gramatová
Sedlčanské s.r.o. | vážení
Ivetka Olbrich | Ivetko Olbrich
Jan Rucki | Jane Rucki
Justýna Houžvičková | Justýno Houžvičková
Zdeněk Flek | Zdeňku Fleku
Jaroslav Šindler | Jaroslave Šindlere
Jiří Holoubek | Jiří Holoubku
Martin Vojvoda | Martine Vojvodo
Milan Bočej | Milane Bočeji
Jarmila Nováková | Jarmilo Nováková
Jiří Havlas | Jiří Havlasi
Josef knop | Josefe Knope
Ivana Kašparová | Ivano Kašparová
Hanka Blažková | Hanko Blažková
Filip Havelka | Filipe Havelko
Martin Česnek | Martine Česneku
Zdeněk Vodička | Zdeňku Vodičko
Jiří Kamenský | Jiří Kamenský
Petr Němeček | Petře Němečku
Tereza Konvična | Terezo Konvičná
Jana Prnková | Jano Prnková
Jana Krčálová | Jano Krčálová
Marcela Buchalová | Marcelo Buchalová
Eva Malušová | Evo Malušová
Anna Batistová | Anno Batistová
Ladislav Hynar | Ladislave Hynare
Radek Stloukal | Radku Stloukale
Diana Mušková | Diano Mušková
Barbora Jeslìnková | Barboro Jeslìnková
Belo Mašek | Belo Mašku
Marian MikloMš | Mariane Miklomši
Viera Ralbovská | Viero Ralbovská
Pavel Mazan | Pavle Mazane
Petr Janák | Petře Janáku
Pavel ricka | Pavle Ricko
Pavlína Terberová | Pavlíno Terberová
Bohumil Novák | Bohumile Nováku
Miroslav Soukup | Miroslave Soukupe
Michal Bartoš | Michale Bartoši
Martina Zajíčková | Martino Zajíčková
Michal Skohoutil | Michale Skohoutile
Hana Sedláčková | Hano Sedláčková
Zdeněk Tauchen | Zdeňku Tauchene
Dana Motyčková | Dano Motyčková
Ladislav Kohout | Ladislave Kohoute
Václav Jandera | Václave Jandero
Marie Hnilová | Marie Hnilová
Věra Horská | Věro Horská
Roman Pecha | Romane Pecho
Jan Špetlík | Jane Špetlíku
Jaroslava Rajdlova | Jaroslavo Rajdlová
Jiří Lacina | Jiří Lacino
Josef Krutský | Josefe Krutský
Juraj Kováč | Juraji Kováči
Petra Jetmarová | Petro Jetmarová
Klara Valková | Klaro Valková
Stanislav Blažka | Stanislave Blažko
Václav Šimurda | Václave Šimurdo
Lukas Hubacek | Lukasi Hubacku
Josef Miřatský | Josefe Miřatský
Libuše Hlawiczková | Libuše Hlawiczková
Zdeněk Nosek | Zdeňku Nosku
Petr Sedláček | Petře Sedláčku
Ing. Ludmila Benediktová | paní inženýrko
Ondrej Diblik | Ondreji Dibliku
Mirka Koťátková | Mirko Koťátková
Zdenek Mařata | Zdenku Mařato
Bohumila Štokrová | Bohumilo Štokrová
Vladislav Nerad | Vladislave Nerade
František Kubala | Františku Kubalo
JUDr. Samuel Baránik | pane doktore
Igor Doležal | Igore Doležale
Libor Smýkal | Libore Smýkale
Vít Šimara | Víte Šimaro
Lenka Svobodová | Lenko Svobodová
Maroš Trojčák | Maroši Trojčáku
Petr Baláž | Petře Baláži
Ivana Novotna | Ivano Novotná
Klára Procházková | Kláro Procházková
Červenka, Michal | Červenko Michale
Michaela Jirutková | Michaelo Jirutková
Jiří Reiter | Jiří Reitere
Eduard Schmidl | Eduarde Schmidle
Jaroslava Krejčířová | Jaroslavo Krejčířová
Ďusi Burmeč | Ďusi Burmeči
Jana Krnáčová | Jano Krnáčová
Radek Palán | Radku Paláne
Zdenka Miticka | Zdenko Mitická
Jan Slabý | Jane Slabý
Lucie Dvorakova | Lucie Dvoraková
Monika Vobecká | Moniko Vobecká
Radek Čečrdle | Radku Čečrdle
Magda Kučerová | Magdo Kučerová
Tadeáš Štěpánek | Tadeáši Štěpánku
Pavla Hornová | Pavlo Hornová
Radko Chmelík | Radko Chmelíku
Alena Šalamonová | Aleno Šalamonová
Lucie Spěšná | Lucie Spěšná
Martin Janka | Martine Janko
Franc Pavel | Franci Pavle
Anežka Dudicová | Anežko Dudicová
Anna Opluštilová | Anno Opluštilová
Petra Zárubová | Petro Zárubová
Monika Turanová | Moniko Turanová
Radovan Ambrož | Radovane Ambroži
Zdeněk Zobač | Zdeňku Zobači
Naďa Lahodová | Naďo Lahodová
